#########
####.  @#
#  $$$  #
#.##.##.#
#   $   #
#  $.# ##
####   ##
#########